-EM-----B----X--EX--X---M-X-?--------------X--EX----X-E-o--B-B--M---E--E--E------E--X-X--E---?------o---X-B--?BE----?-E---------EB--XX-X?-B-----B---X--B-BB-------o---------X----B-EB-----oX-------X----
----------o-X-?-E---o---o---o------X-E--------XXX---?--------o------BXX-----------B---E----X---------XE---BX------M--o---o------XX--B-?---M------B--E----X-X--------------E-B----E--o--B--M-?-----E--B--
---XB----B----------o---?-----oo-----?B-------MX----B--E----B-?-M-----?X-B-----B-------X---EB----------?--oE-X--X----o--o------B---E------X--------?--Xo-----B----------X-----BX-----B-X--MBM-X-B-------
---X--------------o---X---E----XoX-X---X-----B---EEE----o--?--E--------E-------ME--B---X-E--o-------E----M-X-----Xo--B--------X-----------?-----------XE---XMB------E--------B---X----XM--------X-------
--B----BoXM---E----o-B-B---?-----X--X-B-----XE-----X--?EXBX--E----E--E--o------XE--------X?--------EE--X------o-?o---X------------XXX-XE--------?-----X-----X--X-o-E---------?EMXX-B--B-o---XE----------
-E-----EX-E------E----X-oX---B---E--------o--------B--o---------E-E----?--XEX-o----B-------MB----------o--------?-X--BoE-XX--o----XE--BX-------------??--M-------X-o-----BE-BBM-E---XX-----------B--X---
--B-X--X-X-E---X-?XE--X-X-----o--X--B----------X-X-----X-----M--X-M---------E-BX---B----EB------B?------?B-----B-X-XX-----XX-o---------X-oX-----X---XX-----?-------------XX----XE--B-B----o--ME?------B-
----o----M--E-----B--B----X----B------X--B-----E-------?--------?B----B-B------------MBX-----B----B-----E-----------o-M---E---EB-Mo----B--?--o--B---X--o?-X--oX----o------XX---------?------E-?-X-B-B-Xv
-------oX---BB-BB--X-----o----X-B------X---------X-?----M?---E--B--B---------------BBX-------X-------Xo---------oX----X-----?---------X-o-?--?X-E---MEX----X---X---E----------------B---X------Eo--X---f
-------X----B--X--oM--X--o----X----X--X-B-----X---M-o------X-BoXM-------------?BM-XBM----X------E-------X-X---B--?B----M-----B------XM---?E---X-----?---?-----B--------M-XX-------------EMB-----?E-E--of
---B----------E-EE-----o----?---------BE-B--?------o--------E-X-X---X--X----------B-X----o--?----X--------?-------o------X-------?--oX-------X--X-X-------E---EE---E-X-X-?--E-o---E-X-X--oM-E-?-------Ef
-X--------B----E--o------M--E--B---o-?----?-------XX--------BM-X----oo--Eo-?-------B-----------BB----EX---BB----o------X------------E-----XB------------B----o-----Eo?E---------B-B-E-M-----XB--X---EB-f
-------X-------B--X-X--X---o-----o---Xo-M----E---o-------X------X??--oX-M-M------------EE--X------------o-------?--M--E-------------E------------------------?--X---XEE---o--------o---E-B------M-MX---f
--M-----EX-M------X--B-E---M--X-EX-----E--------oB-----o-B--X-E--Bo--EB----E--XE-B----X-----X--Xo-?----XX?--Xoo-------Xo---------E------E---X-E--------------?--X--B------o---?----MBo--BEB---X------M-f
m----------------EE---------o-M-----M---------MB----------o-MMX--?---oE----M--o--------EB---------oX----X--X--EB--MX--XX--Bo-?XB-?------------X----M-X-------?X-X---EXM--XM------------M--E-X---X-?--?XX
XXXXX--XXX-XX-XXX--XXXXXXXXXXXXXX-XXXXXXXX--XX-XX-XXXX-XXXXX-XXXXXXX--X-X-X--XX-XXX-X-XXXXXX-XXXXX-XX-XXX-XXX--XX-XX--XXXXXXXXX-XXXX-XXXX---XX-XXX-XXXXX-XX-X-XX-XXXX-X-XX-XXXXXXX--XXX-XXXXXXXXXXX-X--X
