-X--X-o-------------EMB----B-----B--X-----oX-------E---------EX-E-E----------oE----X---X-M-XX----o-------B-BBE-XXM-E----------B-XE------X--X----------?---------------E---XB---?BMXo-X-B-X----oE-o--o---
--B--o-------X?o------X----E--X-XX-----------?-?---B---B--B---XEoXM--X----X-----X-------X-?X-X---------E--oX-----XXX------BM-----------?-------E-X------------EB-o-X---E-X-------XX---XXo-----X------X--
--MB---MM?X--X--------XX--------X-E----------?---E--X-XM--MX----------M-------------XXX-X-oo---EXX--X-X-----X-M---B-----------M--------X--------------o--------E-B------B-------X-M----M---B-X-------XX-
---B---------E--X---X-MB-----E-XB-B--X-B------E-BXMo-----X---E-?------?-E-XE----X----XE-------X---X--------E--E---E-B----o--o-----------------X-X-M---E--------------o--X--XB-----X-?XBEE--X-E---?o-----
-E--E--?-----------X--?---X--XM---B?--X?-----X---B----B-oo----B-o-M--X--?--X---------B---X-------------X-XXo----E--XBo-M---B-X-XX------------X--X--X------B---o--o------------o---X-XB----------BEB-E---
----M--o--E--B------B----X?--X--------EM--?--?--E-----M-?----M--B--oE-----B--B-X-?-------o------------B-XX-B-------X-------B---XXB----------XEX-------------o-?-o--E-B-?-B----?-------B---XXo--B-?---X--
------EX--o--X-E-X---X---?------------E--X---XX---o?--E------E------X-BB-------BX--o-----?----B-X-?X---Xo--E----------MB-X-o---X-EX----------E--XE----E---?---X----------EMX-oB-------?--Bo------o--BX--
----X----------------XB-B--Bo----XX---Mo--X------Xo----------X-B----E-X?--XXE---------XE?X------?----o-XE----------E------X-B-X----o----X-----------?---?o-XB-o-----MM-----MBE------o-------X----------v
-X----------E---E----XX----E--X--?-----X-----X---?M--EB--?EE-X-------B-----X----X-X-----------------X--M----X-XoX-----------X------B---E---o---o-E-BX---o-XB---?------BXX---X-XX-----------E---------?-f
-X------XX-----------o-------oo----XX------o---X--?E-X?-M------B-oE--XE-------------X----XB--?Xo----M--X--X?-ME-?----o------X-X-X----o?EX----X------X-----oBo---X----?---X----?----X------------B------f
-E--M-?---Mo-o-X--o---------?E-B---------------M-XBE-----B---X-X--XM---XBo--M--X--E------?-------------X-X---M---X---------------?B----XX-----MM----E?-X--M-------X----X--B-X-M-?-M-------M-BXM---XM--Xf
----M----EX---X----X-----X-X-B---------------?---X-B---B-MEX------M--X-XE------X------?X-BXB--X---X-------E----X--E--X------?----X-----X--?-B-ME-----E-----------EM-MME--o----o-X-?XMM----B-M---------of
--XXoE---E-E--------B----E--EX-B-X------X--E----X--X---X--EM-?------?-------X---M-?--B------E----EX--Eo-----E---E-----M--Xo-B---M----?----BBXXM---X--XX----?---B----X-B-------E-X-ME-B------X------o-XXf
-----B----??X-E---M-?---E---XX-------M--X-----X----B----E----------?----E-B-----o----------XM-------------------M--o--B?---X--------------B-o---E-X-------o---------X--------------o---E-?------B--X--Mf
m------E----M---o------?-------------o---XX------o--X--Xo------MX---B-----B---------X---X----B-X-X--------E--X-----------X-------oX-B-E---?----X-X?-XB-B------------X-------B----------XX---------oX--MX
X-X-X-X-XXXX--XXX-XX----XX-XXXXXXXX-XXX-XX-XXXXXXXX-X-XXX-XXXX-X-XXXX-XXXXXXXX-XXXXX----XXXX-XXX-XXXXXXXXX-XXXXXXX-XXXXXXXXXXXXXXXXXXXX-XXXXXXXX-XXXX-XXXXX-XXXX--X-XX-XX-X-XXX-XXX-X-XXX-XXX-X-X-X-XXXX
