M-MX-X-?EE-XE?-X-?M---B-XX--?XoX-MEB?--B--M-Xo--X--X-Bo-X-BXX--E--B-XE--M--?--o--MXE-o---M--B--XM?X--M---M--X---X--------XMX-oE-BX-?--EBM-?---BMM--E?-X-X----XE--E-X--?----XX---oMMo-o-E--M-----o--??-MX
?--Xoo--M-Eo-EXXX?---X-oX-E----XE---o-----BB-X--------o-?--B?--XE-XXEX--X--XX-E-----XX---------?--o--E---E----X-----?--X--?B-EBEo-----E--X-X--o-B--EXX-B-----B-----B-?-E--M-XEX-X-Xo-B---------?--XE---B
?--?M--Xo----E--BBB---XMo-E----Eo-o?----B--X-E-B--------B-X?--XM---X-o-ME-E---Mo-o--XX----?X-?---BX-?EE--X-E-?----o?----o-?X-?XoE?X--X-X-?--M-?-M--X----B---X?--X---EE-Xo-B----EX---X----XX-------M--X-o
|X--?--BE--?X-B--o-----Mo?------X-------B-------o-M-----?-B---MM-------XM-?--X---B---BX---?MMM----Eo-M------B-o--XB-X-----?-?BXE-o?-o--E-----------MX---Mo------X----o-B-X?---XX----BX--B------EE-?-----
|EX-Bo--?-Xo?-B-------Bo?E-X--E-----------o--X--X------X--?-E-X?----X--oXoXXX-M--o---Mo-----E-oB--E------B-BB-X-X---Eo?-XoX-XXoBX?-M---X---M-----o-----Xo---X-XXEMXM-MXMXX-----o-B?-?-----------E------|
o-?XXoMXX-----oXBX--oXE-----X-X-X-----X--E-------oo----B-XX-E-M-X-----MBXoX-M-MoX-X--XoXX-X----?oB----M--X-X---XB---oE-B?--??MX-----EX-X---------------E----B-BXM?-M------EXM----MX-?X--------X-oE-B--o?
--BB?-?-M---X-X-B--?---X----o--E?---B--E-o-X---X-?--?MoX---MX------o--X-??B---X--?B--XE---E--Eo-XX-B-?---?-----Xo---??-EX--XBoX---X-EX-E-----X----X--o-E-?--XE?X---EB----?--------o-BX-XX-X-oB--X--?-MEE
?E-XX---------?-XB--B----X--B-oM-X-MXX-?X-XXEX--o--o-?--o-XX---M----?-----o----------MX-B-?X-E--M---oM---X----?X-MB-??-M?--M-o----E----o-?-B--o-B---X-oE-oXBEBE--BX??--XBE-X-o---Bo-E----X?-EX----XB-MXv
|---XB--X----XEX-X---BX-?X-EB---XX--?-o?M-XE-XX--X-X-------BMB-----??X-X--X-oE---------?X-XE-X----X-o---XXMX--M?-X--o-XBBXBX----E-B-M--EX--o----X-X----?B-X-XX---E?---MoE--X---X-XoE--XM-XXM----------B-
?-B-ooXX-B--?oX---X-B---XBo-BXBE-o-?Xo-X?-XoM?--B--X---X---?M--XoX-E?E---BE-BEX-----?MX-E----X-X-??E------XB--XE-M--X-??-----X--X-X-M--E-o-X--o---E---X-----E--o-M----X-o--B-----M-X---B--E-BX----------
oXX---XMEEX?E--EE-E-E----BE-EX---??-M--M--EoE------X-------o--XXMXBEE-EE?-XX--------M-o---------BE---M----?---o---?-oX---------E???-B-EEM---------M-------oXXE-------X-?X---M---o?BEXX-----M-X--EM-EM?-M
----X?o-M?--E---MB--?----o-------BM---BXB-XB?-M---Eo--------o--o-E-MB?E?M--BE-MX-?----o----E--BB----------X-------oXoE---E---X-o--M-----X-?------XE---Eo--?BB-X---M-?-XXoE--E-?E----X----Mo--M-?-B---X-X
-?o-Eoo-o-----XX--E-o-EX-BE--B---E?----M----MB--XX-----E----XX-X-----EXM---B-X-B-----oBBX----E--?-----X?--??-------X--MM-o--o-EX--X----o?-?M---?E-XX-----B-XM-?--XX-M--?-?---EE--X--------E--X--E--M---B
----?M-B-EX-E--X---?X--X-??----------E--?---oXX?-MX---EE--E----E------XMB----X-M-M---EX------M--M--XE-EEM--XX?M----E---?XB----?---E?---M---BEM--XBoB--------E----oM-E----X-X---B-o-M-o-------M----E---BM
m---EE------X-oM--M--B----?--M----X--o--?BMMBB?-X?-E---X-o------XB--o--MB---o----EBB-BoB-----------XE-M-B-oX-XX--E-o-----X----X-BX-XB-------oX---X----X-----E--o-MXXo-o--XoE----MB?XB--X--E-------o---X-
XXXXXXXXXXX-X-X-XXX-XXXXXXXX-XX-XXX-XX-XXXXX-X-XXX-XXXXXXXXX-XXXXXX---X-XXXXXX-XXX--XXXX-XXXX-XX--XXXXX--XXXX--XX-XXX-XXXXXX--XX-XXXXXXXXXXXXXXX-XX-X-XX-XXX--XXXXXXX-XX-XXXXXXXX--XXXXXXXXXXXXXX-XX-X-X
