?XBEB-E-----XX---E-X-?-X-XE--M--o--?-oo----XM--o-X--E--X--X?--BXX-X-XE--B---BXXXE?EXB----M-X-E-Bo--?--X-----XB---XE-B---MoM--MXX?------M----X----oEX--M-EB-E--X-B-------ME--E----?o----X-Mo--E--B-?EXo-o
B--Mo-?-EB-X-?---BBE---M-------o-o-E-o-o---------M--o--------X--M--oXX-Eo-B-M-?----X-M-B-o---------?----?--BMB-M--M-o-?-B-B---B----?-B-o----oo-----B-E---XXB--?--o-----EXB--X--Bo-XM--oX-E-X-BX---EMX-XB
E---E-?--o-X---o-E----XE?------M-----E----EE-----oM-X----X--B----X---X-XX--EB-B-B-?X-o-E-XXBE--X---oM------B----X-B-B--E-EXE-E-X---BB-----E?X?X---BB-B--EX-M--Eo-BX----oXE------------XB-E?E--E--X?X--o-
X-X---B?-B-o--?-M----?M-B-----oX--Bo-------B-----M?---X--Xo?X-XM-----XXoX----X---X??----X-----E---EX-oX----X----E---?--?Xo---E-XX-X-------E--X--o-B-X----X-XX--M--X-E--EX--oX----X----B-B-?XMXo-X-?X--?M
o--X-?X-----?-o------X---X----E?--EBX----X-XXB---XM---o-----ooX--------X---o-M---------M-B----?-Xo-X-oB----M-X-----XB-BXXX------X-M----?----E---o---B----oBXE-----XMXE-B?-----XX------B---E-----M--E--Eo
o-oo----oB-M-XB-----o---------------B--o----B-M---M-B----o---MB-E-BB----E--BM-EX----X-oM-o------EE--X-X-B--B-o?----------o-o-----X--X-B?-?----E----------o?-XXX----X-o---o-E-X?XM?XB------MX--ooE--EE-XT
oX----o----BB-B-?---B--o-M--BX--ME--E--XXX----B---?--M----XX--M---BX-------Xo--B--o-o--X--o-?-X-XoE---X-BX?B-o-XBX----E--E-------XX-XoM--MX-------------E-M-X------E--B-XB-X-M-oE-BM----X-?B?-E-?--XE--?
-X--------?---X-X--X-M-M--X-Eo-XX?--B-XXB-X?--o-X-X?o--XXXMM--XM---X--------M-?B----o--X-BEXEE-EXBX?B-X--B-X--MB-X---EoXEM--B---MXB-MXMX--ooo--X----E-X---M------o----XMM---MX-o----o----XX-?------M-BXv
B--BX?M----E--M-X---BXE----X-?-EXBX----XB------X---XX--X-X-----M-----??---------o-Xo-----?--E?--B--E--o--XXM--oX------B-Xo-oB-M---XoM-----M?X-----X-Xo-M--X--E-EEE------?-X---B---X--M---E?----?-BE--E-M
X-X-EME-----X-MXXEX------X-X-M-------M----------XE-----X---oM?----B---X----------XX--?-?-?-XXo----X?M--X---B---o-----M--B--B--X-o---?E----B-----B--M-o-------X-M----X?-Bo-Eo------?--BB-X?---E?---o----|
X----XX---------oBEX----------------X---M---Xo---M---X-X---o-----BX---B----X--E?-o---o----X-B-B-M--X?-?----oX-?------E---X-?-M-----XEM--X-B--MB-X-----M-?----o-MXX--B--??---X---MX---E--BMEXX-?-----X--M
oX---X---------X---X-----XXB---XXB--X--XX-X-E---XXX-E?M---X---X-----o-B-?--X-o--X-------o-oXo--XX?--?X?X--EMo-XX----B?--oo-M---oo?-MXo--E?B?----XM-----XB---o-M?-X--X--BB---M---?X--oX---M---XX-----X---
X-o--o---BE----?-oE--o-------X-M--M-E-B-?-X-----?---B?----?B--BM---oo-X----X---------M--B--Xo---o---M-oX------MXM-B--?--?--ME--X---?XXB-B----------X---?MX---X-X---?oM--M--------XEEBMX--B---EBM?--XX?-T
B-B--M--M-XXX--------X--oo---M?M---X------o-X--XM----M-----E--M-EX?---o-M-B---------E-o-XX-oXB-B--B-M??oX--?-XXBXo-X---XX-?o?B-X----B-----M---EB---E-B-MXBo-----X-XX-oX---X--XX---E---M--X----BX--XB----
mM-?--o--E-X?----X--X-X--X---XX---BXX--M--X----E?X-??---XB--------o--M-XM-X?-M-----??------?--BBE---XB-X---BX-X--E-E----X-o---X---?---B----X--oB-BBo-B---XMEB-----?E--M--XoXoE---?-M---------?-X-??E?-o|
XXXX-X-XX-XXXXXXX---X-XXX--XXXXX-XX-XXXXXXX-XXXXXXXX-XXX----X-XX-X-XXXXXXXXXX-X-X-XXX-XXXXXX-XXXXXXX-XXX-XXXXX-XXXXXX---XXX-XXXXXXX-X-XX-XXXXXXX-XX-----XX---XXXXXXX-XXXXX-XXXX---XXXXX-X-XX---XXXXX---X
