X-X-X-M-?--E-XX--o-BBo--MEXX--EXXXX-M?EE---B-E-X?-XB-X?E?-X-?--X-MB-EBoX-?E-?E-oM--M--M-M?o----XM--X-?-------E-X---oB--X--?--X-oM--EBo--XX---B----ME--X---B--E-B-o---X----XX---------XX---E--MXXX-BX-XXT
EX--XBB-X?-------X-B-M-----XXB----X-M?o----XE--XM-EX---E--X-M?-EE----B-X-oB-?---o----------o-E-B?--?-B---X-Eo-o--MBB-----------E?-EBXB--?-?X-M-BXXMEo---Moo-X--E--X--E-EB-EX-X---X---X-X--oBB--?X----X-?
X----o-X---X----E--E----------X--X---X--X-MEXX-?-MM----X--X----E---o--X-EoM--X---XX----B---EE---M?-B--X-------X--o--?-?-ME-----Xo--XM---o-E----M-oMB-X---BB-o-BX-BEE--XXE?----B-X---o-XXo-?-oX-B-?-X---T
|--B--XX---o-------B----------?-oo------X------E--MX---X-X----XM-X-X----XBBX-?-oX??----B-----E---MB-B-------X----M---B---------XB--?X--B-BX----X-MX?-X-X-oX----X---X--X--M-MB--BE---o--B--X-o----X----XT
--X-?---E-BE----XE-X-------XX----?----E-B----X----XXE---BB-B?EBX-o-----B-X-X-oXo-?o----E---EBo---E-oo-X---X----o-X------B--B----oB--XX-XM--X---oB-E-XooX-------X-X-oE-X--E---X-o?-EX---?-XEXBB--X-X-?-X?
|-------M----?M-?oX?----EE--o------o-X-------o--MXoXo---Xo---X-o-------?E-X--X---oE--XBE--XBo--B---XEE?-o-?-X--M--?-MB-----o----BB--B---X-Eo---oE-oX---B----o-----X-B-X---X--o?--?-M------BE-X-B----XX-?
X--E-ooMX---B?--EX-B-o----X-M----X-XB--X--EX-----E--o---XB?E-M----BB-X--?-M-BE--X-o-Eo---o---?-oXBoXBMo-o---?---M-X-?Xo-------BXM---B---Eo?---B---EX------?------?E---XEX-M--M?--E-XB-ME-oB---X?---o---X
E--X--BXB----E--o--B-Bo---?-XXX--E-M?--?-XX--E--X---E-E---B?--MX-----X--M-X-XX---??--X--Mo-----X-EXBEo?--o--E---?--E-?B--EX-M---o-B-X--------X-MX-?o---X--B----X--X----?X-X---EX-?-----E?-?--XXE-?-?---v
?-XB--M-B----o--Xo-XB---XX-oB-X---oBB-B-B-BE---o-X----E-BE-----MM----XX-o----o----------X--?---X?-o--X-X--M-BBooX--------X?-?B---M---BB-----------BB-?X-----oE-X-------X--E-o-XB-----oMX?M-E-MBE-------T
X-B-X-E-E--oE---XX----XXE?----oXM-?XM---E?B----o-XXX-----o--X--oM-X-----o----X?-BM--XXM--oX-oBBBMM---XE---X---M---X-B----XXX--X--?--EMXEM----oM---B-Mo-?----X-----XX-?-o-?o-----BE----??-B------XE--MM-M
Eo--B---oEE-X---BXoX---X?X-X---?--E--M--BoX-X----BMX---X-?--E-?X--X--------?--E-oB-o-?-E-M-MXE--?--?---o--o---X--XEBBX---X-EEX------?E-oo--o-?----X----?-?---B---?oX-o-B-X------XX----o?X-M-----M---?-EB
o--oEX--E?--MoB-X----?XMX?MX-E-B--B---?-Bo--E-B-o-XX-E-?----oXBB------X--E??-X-M--M----MoE-oBo--E--oB?----oM--B-XX-E---X---?MX---B-----?B--X-M?---E?-E-EXX?-----B--------XXX---EE-B---Bo-XBo-Eo---B----X
E--X----XM--oM--X-----X?B-MX-?-o-EBX--?-MM------B-o-----E--?-MX-X----X---o-X--EX-oX--M-?--MME-----oX?---o----XX-------M?----B--?X-XM----BBoX---X?-B-?--MX?-----E--XX-E-Xo-XM?E--X-M---MBXME---X-EMB----E
Bo-X-----M------E-BXE-X---XE------?--B-X---B----M-o--------X-?---XoB--oX-XX----X-XX----X---------BoM---EE-E--EX---M---X?--?-?--XE?XE----EoE--M--B-XXX-E----------E?X---XBX----M--B--MBMo-----X-XXEX---?E
m--XXX---------X---XXX?--B--------o--B--E-oB------XM-o-E--?-E-E--M----EB-BB-B--o-BE?-X-----E?----------?XX---X?--o-BoMX---XBX--B----------------?-B-BM-o--E--?---MXB-----oX-B------XB?---M---X----B---Bo
XX-XXX-XXXXXXXXXXXX--XXXXXXXX--XX-X--X-X-XXXXXXXXXXXXX--X-X--X--XXXXXXXX-X-XXXX--X--XXXX-XX-XXXXXX---X--X-XXXXXXXX-XX-X--X-X-XXX--XX-XXXXXXXXX-X-XXXXXX-XXXXXXXXXXX--XX-X-XXXXXXXXXXXXXXXXX-XXXXX-XX-X-X
