--oE-----E------------M-X-BB----XBM-----------E-------X-B----B-X-----X------X-o-E----XXX--E---------X--o----------o----B---------o----o-MM--o-?---M-----o----o----B-BX?-XE--XEX-M----X-X-X-----X----B---
-----M-M--XX----------XBMX--------X--Eo------?M---X--X---M?--------E-X-M---XB-B--------------Boo------------o-------------------------XB--------EE?-E-X------E---E-----E-o--E--------XEo----------------
--------oE--o---M-----X-BE------------------E-----oEX---X?o-BE-B--?-E--X------X---------M-----X--E--X-----X----?-----X----EM--X----B--X-o--X--X---X---------o--E-B---M-B-X--X----------B-----------E----
------M-E-----B--X--------X---M-Bo---------E---M?---XB----E-B--B-B---o---B--------E-----M-----------------E----B-o--X------M---M---M-----------M-------E----?--M-M-----X---XX---X-------------------X---
---X---XM--E----XX-----X------o--M-------?--XXB--X-X--XX----?-X---M-B-XEM--E----E----------XB--------------------o--M---B------X-E--------X----MM-B--B-----M-?------BEo-EB-X----X-X-----EX-B------M-E---
---M---BX--X------------o--?------?-----X----E--M---B-------X-----MM---XB-oM---M--------X-------EX---o--X---------o-X-----X----X----------Mo------------------EE---BX--o-X-XX---o-o-XX-----X--X---------
-----XX-X----------BM---M-E?----X---B---M----?EX--oX--------M----------E-------Eo-X---X--M--X---X-X---o?-XMX--X-X----B-M--------X-X---o-----?---------E----M-X--o--------X-------E------------X-M-Xo-XM-
-B----o----------X?-o---E-------BB------X---B-?---XEX--X--o------o-XE--XM------X-?XE-------B--E---X-?M-------M-----B--o-EX-----X-E-X----E------------E---------o-o-------E--------o----B-X---X?X-------v
--E---------EB?--MM-X----X--X-----X---?----X--B--E---?--B--M-------oo--X-------M--o--------EM----X------?-----B-------------o--M---X----E---X---?X--X--------------E-B-------------?o-E----X-B-X-----M-f
------E---X-BB----EX------B-------X-BB-o-X---M--M--B--X-----X--E------M------o----E---B?-E-E---M----E--------------------o---X----o-B-----------B-XB-XMB--------B-X--X-B--E--X---------------Mo---?---Ef
--X------------------E-o----o-?----XM--------M-------Bo-X-X?---E--o---?----------------M--B---X-----X-M-X-X---o---B---------------B-------E----EoBB--Eo-o---X---E-E-oBXo--E---Xo-------X?X---??--------f
-----X-?-----X-------E---BX-BE---B-----E---E-----M--B----BX-------------------M---------X--o---------XB-EB-B--E--X-o-------?--E-XX-X-X-----BX---E-X-----E-X---E---XE?--EX-------XBE-----X?E----X-------f
--o----X----M--BX------M--X--X-----B-----B?X-------------X-----?-------X---M-X----B-X-XB-----XM-M-----o-XM-X----X----------o----XM----------M---EBX---B-------E-B-o----X---BX-------X-?--------E--X----f
--o--M-------XB-XX------oE--------------BX-------B-----X-M?---o--X--------XM-----X-----------M-B--o----?XX----BE----------Bo--B-----X---X-----?-EE-----B------X---?----E-----o--------X------EE---?X---f
m-X----------?-----XE-B--X-X--------X-----X--XX--------EB---------Xo-----E-XX---Xo--?X-------X-X--X-----E-E--------XX----B---XXX----X-?----X---B--------B------------XEo-----E-M-EB-E------M-o-----X?-BX
XXXXXXX--XX-X-XXXXX-XX-XXX-XXX-XXXXXXXX-X-XX-X-XX-XX-XXXXXXXXXXX-XXXX--XXXXXXX-X-XXXXX-XX-XXXX-XX---XXXX-X-XXXXXXXXXXXXXXXX--X-XXX--XXXXX--X-XXX-XXXXXXXXX--XX-X--XX-XXXXX-XXXXXXXXXX--XX-XXXXXX-X---XXX
