-------EX------------M-E-XX-B-E-----MM?----o------X----o--X-----------------B-------M-------BM-E--MX---X---MXM?o-?o--X---X-X--X-------------E--o?-----M---B-X---EB---------XM--X----o-X-----?---?X-XB---
-----B--MX---X?---E-B--EBX--oE--M--?-B----E-B----?---------MX---------------------XE---------?--X------X---X-?X----X?-----------------o----X----X--B--EX---?X-E---X-X--X-oM-X---MXX-------X-XoX-?-X---M-
----------oE-------M--------EX---------E---B------BB----BX------------------------X--------X---X---------E-X-?-B-o?----o-----X--X-E--B--E---Xo----M---B-----B-?-------X-----B---------?----XBM-o?----X--
--E--------X------X---------o--------X-XB---M??o--M------XX------E-o--X-----M-B--BX--------M---EX----?--XXXXXE-MMXX-----B---------X-Xo-BE--?X-X--X--X-M-----X-X-X--X-B-B----E-----E---X------M----EX--X-
---o--?-------X---X--------------X--X---BEX------M?-----------M------------MM--------XX------X-M-------------EXE---M-------------MX----?----B--Eo-------E--X--X-MX----B--E------X-X---B-X------?--------
----B---------------E------------XX----o-?--o-----------------E-E-----Mo--------?X----M--X----------------o-X-XB---?--X-E-XX-----o-X--X-----Xo-------E--X----------------X-?-oM----X----?-----X---------
-o--MM--------o-E----Xo-----X----E---EE--o--X-?o-------E------X-o----------EBX?-----M----M-?X-Mo---XB-?---E--------?----XX------B----X---E--o--o--XXX-o-E-----E--M-X-X-----M---X-oM--------oXB?E----B---
-B------------?-X-----XX--------X-----------M------?-o--Xo------B----M-X---?--------X----X-X-B--------------------X-----E-----------MX-M-M-XB-------o------------XX--EX-o--------XB--oX----B-B-----?---v
--E?---------?-?o--o------X---------?--X------B-----?--X----X---X----M-XXXX----X--------E--E---X-------X-X--o---B-E---------B--------M-XX------X----XB-----X--------B-?--X--?---?--B--B----XX-E----EM--f
--------XE-----XX----------B--?--E--B-----B---M?-----M-B-?o--------X-B-------X-----o-X--o-oE--XE--E----B-----B-o--E---E---B---o-?--o-M---X-XX--XX-XE-?------B?-X-------------X--XB-X----X----B?-----E-Xf
--?-X----------?-X-X------X--------X---?X-E-o--M-o--M--X-X-X----------------?-----------?-----X---------------------XX--X----o---E----B-X--EE-X----X-X--X------?----XEX----M-XX-------o-?--------B-oXX-f
----X-B-o--o-M---?oEX--MoB--oX--M-------XMM--------M--------X-X-XB-----?-X?-X----------XB--B----E-----X-X----o------M----M---X-----M----X---------B?E-X-B?-XM-X----X---X-----o--X--E--B-o?--B----X--?--f
-------------?X-----B----XX--X-------X-B---XB-------------------?------X-o---------E-B---------B----X---X------X--B-M---oX-o------X----------B?-E--o--------oo-------X----------B----B-?XBo-X--------?-f
----B---X-M--------BE---Eo------------X-----B------X--X----B--EB-----XX-B--X------X-X-----------E--X-EXX----M--o-----M---X---MX----B-B-X----E---B-B---o---B----B--------E-B---?oo---BM------o----E---XBf
m---E--o-X---o--------o--EE--M--X--X--------EX---Bo--X--XX-X---X----E--------B---o----o---------?---X----E--X-X--B---X-------X---------?-?-E-----X-------XBX-------E--B-------X--B-X---X-X--XX---X---X-X
XXXX-XX-XXXX-XXXXXXXX-XX--X-XXX--XXXX-XX--XXX---XXXXX-XX-XX-XXX-X-XX--XX-XXXXXX-XXXX-XXX--XX-XXX-X----XX---XXXXXXXXXX-XXXXXXXX-XX-X-X-XXXXXXX-XXXXXXXXXXX-XX-XXXXXX-XX-XX-X-XXX--X-XXXX-XXXX-X-XXXXXX-XX
