---B---X-----E---X--XX-------X--X--------X-B-BBXE--BE-----X--X-X-X---X---BXM-------X-EX---------------X-X-----X---X----E-E-------X----XXX----E--X-----X-----E---B---X-X--------X-E-E--X-----E--------B--
---------B-?X-E-XE--X--X----oB--BE----X---E-X----o-------E---X--------X---E--o-X-------------------------X---XM-------?-----------B----X--XE---X----X----XX--E-X--------BXX-EXo----XB----X---------X-E?-
--E---------BX------X-----X----B---X---------X-------------X---X-B---B-------XB-XE--X-E?XX--B-----X------XX-B-X-----E-----BX-----------------X-E---o-----------B-X--XX--------M-X-------B----------X----
-X-oEX-------M---X---------------X-B--XX---EX-EX--B---EXEM---B---E-----X--o----X------X--o-oXX---------X-B----------B-----X-o-----------X----X---?------o--EE-----X----E--BM----E----X---B--------------
-------XB-----Xo--X---------B--------B------o---?E--E----X-----------------E-XEXoo-X-X---------X------------X------E---oX---X----E-X--------X-X-B-B----X-EXE--XX-----------X-?-o---?-M----o--------M----
--------B-XB--M----BXE---o-------X-----------oMX-----------?-X---B----E----?XX-----------X---o-X----X-------X----------B-----o-----X---X---X-X-BE----------E-----E-E------------E---X-E---X-X----X-oEBX-
-----B-----o-BE---X-BB--B--------X-----X-----------M----X-XX---E----X--------X---X--X-EX---E--X-XX-X---E-------X--EB-E---E-----X---X-X---X---X---------------X-----B--M-----M--E-----X-B---X----?-------
---X-o--XX---------X---------X---X--o-X-----X--X--X---X-----o---B-E--X--?---------EE---X------X-X-B--------XX--M?----------?X--?-XXX---------o----X---EXXX-X-EX-----X---X----------X------EX-B-X----B-Bv
-XX---XXX--E--Xo----------X---B------EX-B-X-X-----XoB-----B-E----------B-X-------B-E---------X--M-X-----XE----X----X--X-----X-----?---------XXX-------XB-B-XX--------BXX-----XX----o---X-X------E----E-f
---------------?--B-----o---XX---B---X---B----------X--X-o--------o-------M-------X---B--o--B--X----X-------BE---XM-X-B-----X--X-o-X--?-M-XX--M--oE----------------B---X-X----B--oB--M-XE-EEXBX-B-EXXX-f
---B-o---XBE-------X---X----------?X-------X--X-----oEX--?-X--EX-------X--E--B----------BB---------X-X---XB--XXEX-----E-B-X---------M-?BXX----o------M-B------E--------BBX----X--EEXXXE--B--X------o-X-f
----B-----E----X----XB-------X-X--X----XE-----------E?-----BM--XX-E-----X--o-X--E--------X-XXX-------MX----o?E--X----X----E---E----EBE-EBE-E-X--E---------oX---------E-XX---oXEX--B------X-X--?X--o----f
---X--B---M---B---o--X--o-----E----E--EXo---B--X----X-E---XX----X-E---E-----?---X-------E-XBX----X----X----X---BE---------XX--E-------------X-MX-EXE-EEE------M--X---?X---X-oE---X-X----------X--------f
------------X--X--E------------------o-o---------Xo--X-------X---X-X--E----X--E--XX-B------X---X--X-o--?-B-B------o----XB-B---X-----X-E--------?--X-EB-X----X--X---X?--------B------X--XX---E--E?XX----f
m---E--B--o-------X?----X----E---X-MX----E-X-------B----E------------E------------B--------E---X-BX-B-------EXEX----XEo--B-X--------------BoBX--XE-----X-o---X------X-X-----XEX-X--E--o-o-X---------BEEX
XXXX-X-XXXX-XXXX-XX-XXXXXXXXX--X---X-XXXXX-XXX-XXXX-X-XXX--X-XX-X---XXXXX-X--XXX-XXXXXXXXXXXX--X-XXX-X---X-X-XX--XXXXXXX-X--X-X--XX-XX-XXXX-XX--X-XX-XXXXXXXXXXXX-XX-XX-XXX-XXXXXX-XXX-X--XXX-XXXXX-XXXX
